2,2,2,2,2,2,2,2,2,2,2,2,2,2,2,2,
2,2,2,2,2,2,2,2,2,2,2,2,2,2,2,2,
2,5,4,4,1,3,3,5,4,4,1,3,3,5,4,4,
2,4,3,3,4,2,2,4,3,3,4,2,2,4,3,3,
2,4,2,2,4,2,2,4,2,2,4,2,2,4,2,2,
2,4,2,2,4,2,2,4,2,2,4,2,2,4,2,2,
2,4,2,2,4,2,2,4,2,2,4,2,2,4,2,2,
4,6,3,3,5,4,4,6,3,3,5,4,4,6,3,3,
2,2,2,2,2,2,2,2,2,2,2,2,2,2,2,2,
2,2,2,2,2,2,2,2,2,2,2,2,2,2,2,2,

